{
  "data": {
    "ARI": {
      "points": {
        "2015": 489,
        "2017": 295,
        "2018": 225,
        "2019": 361,
        "2020": 410,
        "2021": 287,
        "2016": 418
      }
    },
    "ATL": {
      "points": {
        "2016": 540,
        "2015": 339,
        "2020": 396,
        "2018": 414,
        "2019": 381,
        "2021": 178,
        "2017": 353
      }
    },
    "BAL": {
      "points": {
        "2016": 343,
        "2017": 395,
        "2015": 328,
        "2021": 231,
        "2018": 389,
        "2020": 468,
        "2019": 531
      }
    },
    "BUF": {
      "points": {
        "2015": 379,
        "2016": 399,
        "2018": 269,
        "2019": 314,
        "2020": 501,
        "2017": 302,
        "2021": 280
      }
    },
    "CAR": {
      "points": {
        "2015": 500,
        "2016": 369,
        "2018": 376,
        "2017": 363,
        "2020": 350,
        "2021": 205,
        "2019": 340
      }
    },
    "CHI": {
      "points": {
        "2017": 264,
        "2015": 335,
        "2016": 279,
        "2018": 421,
        "2021": 150,
        "2019": 280,
        "2020": 372
      }
    },
    "CIN": {
      "points": {
        "2018": 368,
        "2016": 325,
        "2019": 279,
        "2020": 311,
        "2015": 419,
        "2017": 290,
        "2021": 236
      }
    },
    "CLE": {
      "points": {
        "2016": 264,
        "2018": 359,
        "2019": 335,
        "2020": 408,
        "2021": 231,
        "2015": 278,
        "2017": 234
      }
    },
    "DAL": {
      "points": {
        "2015": 275,
        "2016": 421,
        "2017": 354,
        "2018": 339,
        "2021": 284,
        "2019": 434,
        "2020": 395
      }
    },
    "DEN": {
      "points": {
        "2015": 355,
        "2019": 282,
        "2017": 289,
        "2020": 323,
        "2016": 333,
        "2021": 200,
        "2018": 329
      }
    },
    "DET": {
      "points": {
        "2016": 346,
        "2017": 410,
        "2015": 358,
        "2019": 341,
        "2020": 377,
        "2021": 150,
        "2018": 324
      }
    },
    "GB": {
      "points": {
        "2015": 368,
        "2016": 432,
        "2017": 320,
        "2018": 376,
        "2020": 509,
        "2021": 216,
        "2019": 376
      }
    },
    "HOU": {
      "points": {
        "2016": 279,
        "2015": 339,
        "2017": 338,
        "2018": 402,
        "2020": 384,
        "2021": 128,
        "2019": 378
      }
    },
    "IND": {
      "points": {
        "2018": 433,
        "2015": 333,
        "2019": 361,
        "2021": 268,
        "2016": 411,
        "2020": 451,
        "2017": 263
      }
    },
    "JAX": {
      "points": {
        "2016": 318,
        "2015": 376,
        "2017": 417,
        "2018": 245,
        "2019": 300,
        "2020": 306,
        "2021": 149
      }
    },
    "KC": {
      "points": {
        "2015": 405,
        "2016": 389,
        "2018": 565,
        "2019": 451,
        "2017": 415,
        "2020": 473,
        "2021": 262
      }
    },
    "LV": {
      "points": {
        "2015": 359,
        "2016": 416,
        "2017": 301,
        "2018": 290,
        "2019": 313,
        "2020": 434,
        "2021": 210
      }
    },
    "LAR": {
      "points": {
        "2016": 224,
        "2015": 280,
        "2020": 372,
        "2017": 478,
        "2019": 394,
        "2018": 527,
        "2021": 271
      }
    },
    "LAC": {
      "points": {
        "2017": 355,
        "2015": 320,
        "2019": 337,
        "2021": 219,
        "2016": 410,
        "2020": 384,
        "2018": 428
      }
    },
    "MIA": {
      "points": {
        "2016": 363,
        "2015": 310,
        "2018": 319,
        "2019": 306,
        "2021": 177,
        "2017": 281,
        "2020": 404
      }
    },
    "MIN": {
      "points": {
        "2021": 221,
        "2018": 360,
        "2019": 407,
        "2015": 365,
        "2017": 382,
        "2020": 430,
        "2016": 327
      }
    },
    "NE": {
      "points": {
        "2016": 441,
        "2015": 465,
        "2017": 458,
        "2018": 436,
        "2019": 420,
        "2020": 326,
        "2021": 275
      }
    },
    "NO": {
      "points": {
        "2015": 408,
        "2016": 469,
        "2021": 222,
        "2018": 504,
        "2019": 458,
        "2020": 482,
        "2017": 448
      }
    },
    "NYG": {
      "points": {
        "2016": 310,
        "2015": 420,
        "2018": 369,
        "2020": 280,
        "2019": 341,
        "2017": 246,
        "2021": 179
      }
    },
    "NYJ": {
      "points": {
        "2016": 275,
        "2015": 387,
        "2017": 298,
        "2020": 243,
        "2018": 333,
        "2019": 276,
        "2021": 161
      }
    },
    "PHI": {
      "points": {
        "2019": 385,
        "2015": 377,
        "2016": 367,
        "2020": 334,
        "2021": 257,
        "2017": 457,
        "2018": 367
      }
    },
    "PIT": {
      "points": {
        "2015": 423,
        "2016": 399,
        "2021": 177,
        "2018": 428,
        "2019": 289,
        "2020": 416,
        "2017": 406
      }
    },
    "SF": {
      "points": {
        "2017": 331,
        "2015": 238,
        "2016": 309,
        "2019": 479,
        "2018": 342,
        "2020": 376,
        "2021": 216
      }
    },
    "SEA": {
      "points": {
        "2016": 354,
        "2018": 428,
        "2021": 181,
        "2015": 423,
        "2017": 366,
        "2019": 405,
        "2020": 459
      }
    },
    "TB": {
      "points": {
        "2015": 342,
        "2016": 354,
        "2018": 396,
        "2020": 492,
        "2019": 458,
        "2021": 279,
        "2017": 335
      }
    },
    "TEN": {
      "points": {
        "2017": 334,
        "2016": 381,
        "2015": 299,
        "2018": 310,
        "2020": 491,
        "2021": 278,
        "2019": 402
      }
    },
    "WSH": {
      "points": {
        "2016": 396,
        "2015": 388,
        "2018": 281,
        "2019": 266,
        "2020": 335,
        "2017": 342,
        "2021": 185
      }
    }
  }
}
